0	2	5	7	4	
1	0	2	0	0
2	0	3	0	1
3	0	0	0	2
4	0	0	0	0
5	0	0	0	0
6	0	7	0	0
7	0	8	0	6
8	0	0	0	7